8 13 1 0 1 12
*************
             
* ***********
* ** * ******
* *    ******
* **** ******
*      **  **
********** **
