10 15 3 0 9 7
***************
* * * * *     *
* *** *** *** *
  ***     *   *
*  *  ** ** ***
** ** ***** * *
**    **  * * *
********* * * *
*             *
******* *******
